1111111111111111111
10000V00C0000001111
1001011111000001111
10010000C0000P01111
10010V0000000E01111
10001111101100000C1
1111111111111111111